.............
.............
.............
.............
AAAAAAAAAAAAA
BBBBBBBBBBBBB
CCCCCCCCCCCCC
DDDDDDDDDDDDD
AAAAAAAAAAAAA
BBBBBBBBBBBBB
.............
.............
.............
.............
.............
.............
